Abruzzo	
 Ospedale SS Annunziata 	Chieti
 Presidio Ospedaliero di Pescara 	Pescara
Basilicata	
Ospdale San Carlo	Potenza - 
Provincia autonoma di Bolzano	
 Ospedale di Bolzano 	Bolzano
Campania	
 Ospedale Cotugno - II Divisione 	Napoli
 AORN di Caserta -Sant'Anna e San Sebastiano 	Caserta
 AOU Vanvitelli Università della Campania L. Vanvitelli 	Napoli
 AOU Policlinico Federico II 	Napoli
Emilia Romagna	
 Arcispedale Sant'Anna 	Ferrara
 Policlinico S. Orsola-Malpighi 	Bologna
 Arcispedale S.Maria  Nuova 	Reggio Emilia
 Bologna Checkpoint	Bologna
 Policlinico di Modena 	Modena
Friuli	
 Ospedale S. Maria della Misericordia 	Udine
Lazio	
 AOU Policlinico Umberto I - Malattie Infettive A 	Roma
 Policlinico Tor Vergata - Roma 	Roma
 Ospedale SM Goretti 	Latina
 Ospedale Bel Colle 	Viterbo
 Policlinico Agostino Gemelli 	Roma
 Roma Checkpoint	Roma
 INMI 'L Spallanzani' 	Roma
Liguria	
 Ospedale Galliera 	Genova
 Ospedale Policlinico San Martino 	Genova
Lombardia	
 Ospedale San Raffaele 	Milano
 Ospedale Sacco 1a Div. 	Milano
 Spedali Civili 	Brescia
 Ospedale Maggiore Policlinico Ca' Granda  	Milano
 Ospedale di circolo di Busto Arsizio 	Busto Arsizio
 Ospedale Niguarda 	Milano
 Ospedale San Paolo 	Milano
 Ospedale San Gerardo 	Monza
 Milano Checkpoint	Milano
 Ospedale civile di Legnano 	Legnano
 Ospedale Papa Giovanni XXIII 	Bergamo
Marche	
 Ospedali Riuniti Torrette - Immunologia Clinica 	Ancona
Piemonte	
 Ospedale Amedeo Savoia a direzione Universitaria 	Torino
 Ospedale  SS. Antonio e Biagio e C. Arrigo 	Alessandria
Puglia	
 AOU Ospedali Riuniti 	Foggia
 Policlinico di Bari 	Bari
Sardegna	
 AOU di Sassari 	Sassari
 AOU di Cagliari Policlinico Universitario Duilio Casula 	Cagliari
Sicilia	
 Ospedale Umberto I	Enna
 Ospedale Umberto I 	Siracusa
 BORSELLINO UOC MALATTIE INFETTIVE	Trapani
 AOU Policlinico Gaetano Martino 	Messina
 Policlinico Giaccone 	Palermo
 Presidio Ospedaliero Garibaldi-Nesima 	Catania
 ARNAS Civico 'Civico Di Cristina Benfratelli'	Palermo
Toscana	
 Ospedale S.Maria Annunziata 	 Bagno a Ripoli 
 Ospedale Careggi	Firenze
 Ospedale San Jacopo - AUSL Toscana Centro 	Pistoia
 AOU Senese S.Maria alle Scotte 	Siena
Provincia autonoma di Trento	
 Ospedale Santa Chiara	Trento
Umbria	
 Ospedale S. Maria della Misericordia di Perugia 	Perugia
Veneto	
 Azienda Ospedaliera di Padova 	Padova
 Ospedale di Vicenza - ULSS8 	Vicenza
